{
    "enemyPath"     : ":/paths/path_2.txt" ,
    "gold"   		: 320,
    "waves"         : [[3, 0, 0, 0, 0, 0, 0],
                       [5, 1, 0, 0, 0, 0, 0],
                       [5, 3, 0, 0, 0, 0, 0],
                       [2, 5, 2, 0, 0, 0, 0],
                       [0, 0, 1, 0, 3, 0, 0],
                       [0, 0, 0, 0, 4, 1, 0],
                       [1, 8, 4, 0, 4, 1, 0],
                       [1, 9, 6, 0, 7, 2, 0],
                       [1, 9, 8, 1, 6, 4, 1],
                       [1, 9, 8, 2, 5, 5, 2],
                       [1, 8, 7, 3, 6, 5, 3],
                       [0, 5, 8, 5, 5, 7, 6]]
}
