{
    "enemyPath"     : ":/paths/path_3.txt" ,
    "gold"   		: 330,
    "waves"         : [[3, 0, 0, 0, 0, 0, 0],
                       [4, 1, 0, 0, 0, 0, 0],
                       [5, 2, 0, 0, 0, 0, 0],
                       [6, 3, 0, 0, 0, 0, 0],
                       [0, 0, 0, 0, 3, 0, 0],
                       [1, 7, 0, 0, 4, 0, 0],
                       [0, 4, 4, 0, 2, 1, 0],
                       [0, 0, 1, 0, 4, 3, 0],
                       [1, 0, 0, 0, 5, 4, 1],
                       [0, 3, 4, 1, 4, 3, 1],
                       [0, 4, 5, 1, 4, 5, 2],
                       [0, 0, 1, 0, 5, 7, 3],
                       [1, 4, 6, 2, 5, 5, 3]]
}
