{
    "enemyPath"     : ":/paths/path_1.txt" ,
    "gold"   		: 330,
    "waves"         : [[4, 0, 0, 0, 0, 0, 0],
                       [5, 1, 0, 0, 0, 0, 0],
                       [6, 3, 0, 0, 0, 0, 0],
                       [0, 0, 0, 0, 4, 0, 0],
                       [1, 6, 2, 0, 3, 0, 0],
                       [1, 8, 4, 0, 4, 1, 0],
                       [1, 9, 5, 0, 4, 2, 0],
                       [2, 6, 7, 2, 4, 3, 0],
                       [1, 7, 8, 2, 5, 3, 1],
                       [1, 9, 7, 4, 3, 4, 3]]
}
